{"level":[
     [6, 2, 8, 2, 2, 2, 2, 8, 2, 5],
     [4, 0, 4, 0, 0, 0, 0, 4, 0, 4],
     [4, 0, 4, 0,11, 0,10, 3, 0, 4],
     [4, 0, 4, 0, 4, 0, 0, 0, 0, 4],
     [4, 0, 1, 2, 3, 0,10, 5, 0, 4],
     [4, 0, 0, 0, 0, 0, 0, 4, 0, 4],
     [4, 0,11, 0,10, 2, 2,14, 0, 4],
     [4, 0, 4, 0, 0, 0, 0, 4, 0, 4],
     [4, 0, 4, 0, 6, 9, 0, 4, 0, 4],
     [4, 0, 4, 0, 4, 0, 0, 4, 0, 4],
     [4, 0, 1, 2, 3, 0,10, 3, 0, 4],
     [4, 0, 0, 0, 0, 0, 0, 0, 0, 4],
     [4, 0, 6, 2, 9, 0,10, 5, 0, 4],
     [4, 0, 4, 0, 0, 0, 0, 4, 0, 4],
     [1, 2, 7, 2, 2, 2, 2, 7, 2, 3]
  ],
    "player":{"x":1, "y":1},
    "monster":{"x":3, "y":1}
}